75
74
1 2 0 1 5 0 2 2 1 0
5 1 0 3 3 3 1 3 4 2
5 3 4 5 1 5 0 5 2 1
4 1 4 0 2 4 3 0 1 1
4 5 0 4 3 2 0 4 5 0
1 3 1 0 3 4 1 0 3 1
0 4 4 1 2 2 5 4 2 0
2 1 0 2 5 3 4 5 1 0
2 2 5 5 5 3 1 4 2 2
5 2 0 1 5 4 0 5 1 0
