07
75
3 5 3 1 2 3 1 4 4 4
5 2 0 0 5 4 3 4 1 4
4 5 2 1 4 3 1 4 2 0
0 1 0 1 5 5 0 3 0 5
5 2 3 0 0 5 0 5 4 3
1 3 1 5 2 2 4 0 1 4
5 4 5 2 1 0 5 5 3 1
4 0 1 4 2 0 1 1 2 4
2 4 5 3 5 2 4 0 2 0
2 1 0 0 2 3 5 0 1 4
