93
10
5 1 3 2 4
3 4 1 5 0
1 1 1 4 0
1 0 5 3 1
2 4 3 2 3
4 5 5 5 1
3 3 3 2 0
1 4 0 4 1
2 2 0 4 1
5 0 1 5 3
