04
23
0 5 5 3 1
2 4 1 3 3
2 1 1 1 0
1 0 1 4 5
4 5 1 3 1
0 4 5 2 0
2 4 3 4 1
0 3 5 4 2
2 5 1 5 5
4 5 2 2 4
