01
33
3 4 5 2 0
0 5 4 4 2
3 1 0 2 0
2 1 4 5 3
2 1 5 1 5
