30
11
2 4 3 2 0
4 1 2 5 2
2 5 2 0 3
2 1 3 3 3
5 5 1 4 3
