87
79
0 4 2 1 5 3 0 0 0 0
2 3 5 4 4 3 0 2 3 4
5 0 5 5 0 1 2 4 5 0
2 0 2 1 2 3 1 5 5 0
3 1 2 2 1 5 5 3 5 5
0 4 2 2 0 1 4 2 1 4
1 2 5 2 0 2 2 0 3 1
0 5 5 2 1 3 0 4 2 5
3 5 2 2 4 2 1 5 3 0
1 3 2 4 5 1 5 3 3 4
