10 10
5 6
3 3
4 3 1 5 2 0 2 0 1 5
3 3 3 3 3 0 3 5 5 4
0 0 3 0 3 3 4 1 5 2
1 0 1 3 0 0 3 1 5 1
3 2 5 2 5 3 0 2 2 3
5 4 2 4 3 3 2 5 0 1
0 1 1 2 0 5 0 2 1 0
3 3 3 5 1 1 4 0 5 4
4 5 3 3 5 3 5 1 4 2
5 0 0 2 1 0 2 4 5 3
