10 10
9 1
7 8
4 2 3 2 5 4 4 0 3 0
5 4 0 5 0 4 0 5 1 1
4 3 0 5 4 3 3 2 3 2
1 5 4 3 1 0 4 0 0 2
1 0 5 0 5 1 1 1 3 1
2 1 3 5 1 4 2 0 1 2
1 4 4 0 5 0 2 5 0 1
1 0 1 1 4 5 2 5 3 5
0 2 1 0 1 4 2 3 5 0
0 5 2 3 0 3 5 5 0 5
