5 5
2 1
1 4
2 5 1 4 3
4 0 5 0 3
1 2 1 3 4
1 3 0 2 4
0 0 1 1 2
