5 5
1 1
3 3
2 5 1 4 3
4 0 5 0 3
1 2 1 0 4
1 3 0 2 0
0 0 1 0 2