10 5
6 3
2 0
5 5 5 2 4
1 5 0 5 5
2 4 0 4 4
2 5 0 2 4
1 3 0 5 2
2 3 5 2 1
5 4 4 4 5
1 3 2 1 2
1 0 3 4 1
3 0 3 5 5
