5 5
3 0
0 3
3 1 2 4 4
3 0 1 5 5
1 1 1 2 5
2 1 1 2 3
5 4 3 2 2
