5 10
2 0
2 7
3 5 1 3 1 2 0 4 0 5
5 5 1 4 0 3 3 5 4 1
0 0 2 1 1 1 0 0 5 1
5 3 3 3 2 1 1 4 1 3
5 4 2 3 2 2 3 0 0 4
