62
72
5 0 4 3 3
0 1 3 3 3
0 1 2 3 0
2 4 0 0 3
5 5 0 3 4
5 2 0 4 4
1 5 2 3 5
0 4 1 3 2
4 0 3 0 1
0 0 4 4 2
